{
    "assetId": "data.map.shrine.boss_room",
    "tilesetId": "data.tileset.map",
    "width": 24,
    "height": 24,
    "layers": [
    {
        "name": "floor",
        "usage": "visual",
        "data": [          
            1,1,1,1,1,1,1,1,1,1,1,1,1,1,1,1,1,1,1,1,1,1,1,1,
            1,1,1,1,1,1,1,1,1,1,1,1,1,1,1,1,1,1,1,1,1,1,1,1,
            1,1,1,1,1,1,1,1,1,1,1,1,1,1,1,1,1,1,1,1,1,1,1,1,
            1,1,1,1,1,1,1,1,1,1,1,1,1,1,1,1,1,1,1,1,1,1,1,1,
            1,1,1,1,1,1,1,1,1,1,1,1,1,1,1,1,1,1,1,1,1,1,1,1,
            1,1,1,1,1,1,1,1,1,1,1,1,1,1,1,1,1,1,1,1,1,1,1,1,
            1,1,1,1,1,1,1,1,1,1,1,1,1,1,1,1,1,1,1,1,1,1,1,1,
            1,1,1,1,1,1,1,1,1,1,1,1,1,1,1,1,1,1,1,1,1,1,1,1,
            1,1,1,1,1,1,1,1,1,1,1,1,1,1,1,1,1,1,1,1,1,1,1,1,
            1,1,1,1,1,1,1,1,1,1,1,1,1,1,1,1,1,1,1,1,1,1,1,1,
            1,1,1,1,1,1,1,1,1,1,1,1,1,1,1,1,1,1,1,1,1,1,1,1,
            1,1,1,1,1,1,1,1,1,1,1,1,1,1,1,1,1,1,1,1,1,1,1,1,
            1,1,1,1,1,1,1,1,1,1,1,1,1,1,1,1,1,1,1,1,1,1,1,1,
            1,1,1,1,1,1,1,1,1,1,1,1,1,1,1,1,1,1,1,1,1,1,1,1,
            1,1,1,1,1,1,1,1,1,1,1,1,1,1,1,1,1,1,1,1,1,1,1,1,
            1,1,1,1,1,1,1,1,1,1,1,1,1,1,1,1,1,1,1,1,1,1,1,1,
            1,1,1,1,1,1,1,1,1,1,1,1,1,1,1,1,1,1,1,1,1,1,1,1,
            1,1,1,1,1,1,1,1,1,1,1,1,1,1,1,1,1,1,1,1,1,1,1,1,
            1,1,1,1,1,1,1,1,1,1,1,1,1,1,1,1,1,1,1,1,1,1,1,1,
            1,1,1,1,1,1,1,1,1,1,1,1,1,1,1,1,1,1,1,1,1,1,1,1,
            1,1,1,1,1,1,1,1,1,1,1,1,1,1,1,1,1,1,1,1,1,1,1,1,
            1,1,1,1,1,1,1,1,1,1,1,1,1,1,1,1,1,1,1,1,1,1,1,1,
            1,1,1,1,1,1,1,1,1,1,1,1,1,1,1,1,1,1,1,1,1,1,1,1,
            1,1,1,1,1,1,1,1,1,1,1,1,1,1,1,1,1,1,1,1,1,1,1,1
        ],
        "flags": ["floor"]
    },
    {
        "name": "wall",
        "usage": "visual",
        "data": [
            1,1,1,1,1,1,1,1,1,1,1,1,1,1,1,1,1,1,1,1,1,1,1,1,
            1,0,0,0,0,0,0,0,0,0,0,0,0,0,0,0,0,0,0,0,0,0,0,1,
            1,0,0,0,0,0,0,0,0,0,0,0,0,0,0,0,0,0,0,0,0,0,0,1,
            1,0,0,0,0,0,0,0,0,0,0,0,0,0,0,0,0,0,0,0,0,0,0,1,
            1,0,0,0,0,0,0,0,0,0,0,0,0,0,0,0,0,0,0,0,0,0,0,1,
            1,0,0,0,0,0,0,0,0,0,0,0,0,0,0,0,0,0,0,0,0,0,0,1,
            1,0,0,0,0,0,0,0,0,0,0,0,0,0,0,0,0,0,0,0,0,0,0,1,
            1,0,0,0,0,0,0,0,0,0,0,0,0,0,0,0,0,0,0,0,0,0,0,1,
            1,0,0,0,0,0,0,0,0,0,0,0,0,0,0,0,0,0,0,0,0,0,0,1,
            1,0,0,0,0,0,0,0,0,0,0,0,0,0,0,0,0,0,0,0,0,0,0,1,
            1,0,0,0,0,0,0,0,0,0,0,0,0,0,0,0,0,0,0,0,0,0,0,1,
            1,0,0,0,0,0,0,0,0,0,0,0,0,0,0,0,0,0,0,0,0,0,0,1,
            1,0,0,0,0,0,0,0,0,0,0,0,0,0,0,0,0,0,0,0,0,0,0,1,
            1,0,0,0,0,0,0,0,0,0,0,0,0,0,0,0,0,0,0,0,0,0,0,1,
            1,0,0,0,0,0,0,0,0,0,0,0,0,0,0,0,0,0,0,0,0,0,0,1,
            1,0,0,0,0,0,0,0,0,0,0,0,0,0,0,0,0,0,0,0,0,0,0,1,
            1,0,0,0,0,0,0,0,0,0,0,0,0,0,0,0,0,0,0,0,0,0,0,1,
            1,0,0,0,0,0,0,0,0,0,0,0,0,0,0,0,0,0,0,0,0,0,0,1,
            1,0,0,0,0,0,0,0,0,0,0,0,0,0,0,0,0,0,0,0,0,0,0,1,
            1,0,0,0,0,0,0,0,0,0,0,0,0,0,0,0,0,0,0,0,0,0,0,1,
            1,0,0,0,0,0,0,0,0,0,0,0,0,0,0,0,0,0,0,0,0,0,0,1,
            1,0,0,0,0,0,0,0,0,0,0,0,0,0,0,0,0,0,0,0,0,0,0,1,
            1,0,0,0,0,0,0,0,0,0,0,0,0,0,0,0,0,0,0,0,0,0,0,1,
            1,1,1,1,1,1,1,1,1,1,1,1,1,1,1,1,1,1,1,1,1,1,1,1
        ],
        "flags": ["wall"]
    },
    {
        "name": "collision",
        "usage": "collision",
        "data": [ 
            1,1,1,1,1,1,1,1,1,1,1,1,1,1,1,1,1,1,1,1,1,1,1,1,
            1,0,0,0,0,0,0,0,0,0,0,0,0,0,0,0,0,0,0,0,0,0,0,1,
            1,0,0,0,0,0,0,0,0,0,0,0,0,0,0,0,0,0,0,0,0,0,0,1,
            1,0,0,0,0,0,0,0,0,0,0,0,0,0,0,0,0,0,0,0,0,0,0,1,
            1,0,0,0,0,0,0,0,0,0,0,0,0,0,0,0,0,0,0,0,0,0,0,1,
            1,0,0,0,0,0,0,0,0,0,0,0,0,0,0,0,0,0,0,0,0,0,0,1,
            1,0,0,0,0,0,0,0,0,0,0,0,0,0,0,0,0,0,0,0,0,0,0,1,
            1,0,0,0,0,0,0,0,0,0,0,0,0,0,0,0,0,0,0,0,0,0,0,1,
            1,0,0,0,0,0,0,0,0,0,0,0,0,0,0,0,0,0,0,0,0,0,0,1,
            1,0,0,0,0,0,0,0,0,0,0,0,0,0,0,0,0,0,0,0,0,0,0,1,
            1,0,0,0,0,0,0,0,0,0,0,0,0,0,0,0,0,0,0,0,0,0,0,1,
            1,0,0,0,0,0,0,0,0,0,0,0,0,0,0,0,0,0,0,0,0,0,0,1,
            1,0,0,0,0,0,0,0,0,0,0,0,0,0,0,0,0,0,0,0,0,0,0,1,
            1,0,0,0,0,0,0,0,0,0,0,0,0,0,0,0,0,0,0,0,0,0,0,1,
            1,0,0,0,0,0,0,0,0,0,0,0,0,0,0,0,0,0,0,0,0,0,0,1,
            1,0,0,0,0,0,0,0,0,0,0,0,0,0,0,0,0,0,0,0,0,0,0,1,
            1,0,0,0,0,0,0,0,0,0,0,0,0,0,0,0,0,0,0,0,0,0,0,1,
            1,0,0,0,0,0,0,0,0,0,0,0,0,0,0,0,0,0,0,0,0,0,0,1,
            1,0,0,0,0,0,0,0,0,0,0,0,0,0,0,0,0,0,0,0,0,0,0,1,
            1,0,0,0,0,0,0,0,0,0,0,0,0,0,0,0,0,0,0,0,0,0,0,1,
            1,0,0,0,0,0,0,0,0,0,0,0,0,0,0,0,0,0,0,0,0,0,0,1,
            1,0,0,0,0,0,0,0,0,0,0,0,0,0,0,0,0,0,0,0,0,0,0,1,
            1,0,0,0,0,0,0,0,0,0,0,0,0,0,0,0,0,0,0,0,0,0,0,1,
            1,1,1,1,1,1,1,1,1,1,1,1,1,1,1,1,1,1,1,1,1,1,1,1
        ],
        "collisionTypes": {
            "0": { "solid": false },
            "1": { "solid": true }
        }
    }
    
  ],
  "decorations": [
        {
            "id": "portal.region",
            "tileId": "portal",
            "x": 10,
            "y": 20,
            "size": { "w": 4, "h": 3  },
            "flags": []
        },
        {
            "id": "skill.rin",
            "tileId": "skill.tile.rin",    
            "x": 6,                         
            "y": 17,
            "size": { "w": 2, "h": 2 },      
            "flags": ["skill"]    
        },
        {
            "id": "skill.pyo",
            "tileId": "skill.tile.pyo",
            "x": 3,
            "y": 13,
            "size": { "w": 2, "h": 2  },
            "flags": ["skill"]
        },
        {
            "id": "skill.to",
            "tileId": "skill.tile.to",
            "x": 3,
            "y": 9,
            "size": { "w": 2, "h": 2  },
            "flags": ["skill"]
        },
        {
            "id": "skill.sha",
            "tileId": "skill.tile.sha",
            "x": 6,
            "y": 5,
            "size": { "w": 2, "h": 2  },
            "flags": ["skill"]
        },
        {
            "id": "skill.kai",
            "tileId": "skill.tile.kai",
            "x": 11,
            "y": 3,
            "size": { "w": 2, "h": 2  },
            "flags": ["skill"]
        },
        {
            "id": "skill.jin",
            "tileId": "skill.tile.jin",
            "x": 16,
            "y": 5,
            "size": { "w": 2, "h": 2  },
            "flags": ["skill"]
        },
        {
            "id": "skill.retsu",
            "tileId": "skill.tile.retsu",
            "x": 19,
            "y": 9,
            "size": { "w": 2, "h": 2  },
            "flags": ["skill"]
        },
        {
            "id": "skill.zai",
            "tileId": "skill.tile.zai",
            "x": 19,
            "y": 13,
            "size": { "w": 2, "h": 2 },
            "flags": ["skill"]
        },
        {
            "id": "skill.zen",
            "tileId": "skill.tile.zen",
            "x": 16,
            "y": 17,
            "size": { "w": 2, "h": 2 },
            "flags": ["skill"]
        }
    ],
    "triggers": [
        {
            "triggerId": "skill.to_rin",

            "x": 6,                         
            "y": 17,
            "size": { "w": 2, "h": 2 }      
                
        },
        {
            "triggerId": "skill.to_pyo",

            "x": 3,
            "y": 13,
            "size": { "w": 2, "h": 2 }
            
        },
        {
            "triggerId": "skill.to_to",

            "x": 3,
            "y": 9,
            "size": { "w": 2, "h": 2 }
            
        },
        {
            "triggerId": "skill.to_sha",

            "x": 6,
            "y": 5,
            "size": { "w": 2, "h": 2 }
            
        },
        {
            "triggerId": "skill.to_kai",
            
            "x": 11,
            "y": 3,
            "size": { "w": 2, "h": 2 }
            
        },
        {
            "triggerId": "skill.to_jin",
            
            "x": 16,
            "y": 5,
            "size": { "w": 2, "h": 2 }
            
        },
        {
            "triggerId": "skill.to_retsu",
            
            "x": 19,
            "y": 9,
            "size": { "w": 2, "h": 2 }
            
        },
        {
            "triggerId": "skill.to_zai",
            
            "x": 19,
            "y": 13,
            "size": { "w": 2, "h": 2 }
            
        },
        {
            "triggerId": "skill.to_zen",
            
            "x": 16,
            "y": 17,
            "size": { "w": 2, "h": 2 }
            
        }
    ]
}
