{
    "assetId": "data.map.shrine.tutorial",
    "tilesetId": "data.tileset.map",
    "width": 13,
    "height": 32,
    "layers": [
    {
        "name": "floor",
        "usage": "visual",
        "data": [          
            0,0,0,0,0,0,0,0,0,0,0,0,0,
            0,0,0,0,0,0,0,0,0,0,0,0,0,
            0,0,0,0,0,0,0,0,0,0,0,0,0,
            0,0,0,0,0,0,0,0,0,0,0,0,0,
            0,0,0,0,0,0,0,0,0,0,0,0,0,
            0,0,0,0,0,0,0,0,0,0,0,0,0,
            0,0,0,0,0,0,0,0,0,0,0,0,0,
            0,0,0,0,0,0,0,0,0,0,0,0,0,
            0,0,0,0,0,0,0,0,0,0,0,0,0,
            0,0,0,0,0,0,0,0,0,0,0,0,0,
            0,0,0,0,0,0,0,0,0,0,0,0,0,
            0,0,0,0,0,0,0,0,0,0,0,0,0,
            0,0,0,0,0,0,0,0,0,0,0,0,0,
            0,0,0,0,0,0,0,0,0,0,0,0,0,
            0,0,0,0,0,0,0,0,0,0,0,0,0,
            0,0,0,0,0,0,0,0,0,0,0,0,0,
            0,0,0,0,0,0,0,0,0,0,0,0,0,
            0,0,0,0,0,0,0,0,0,0,0,0,0,
            0,0,0,0,0,0,0,0,0,0,0,0,0,
            0,0,0,0,0,0,0,0,0,0,0,0,0,
            0,0,0,0,0,0,0,0,0,0,0,0,0,
            0,0,0,0,0,0,0,0,0,0,0,0,0,
            0,0,0,0,0,0,0,0,0,0,0,0,0,
            0,0,0,0,0,0,0,0,0,0,0,0,0,
            0,0,0,0,0,0,0,0,0,0,0,0,0,
            0,0,0,0,0,0,0,0,0,0,0,0,0,
            0,0,0,0,0,0,0,0,0,0,0,0,0,
            0,0,0,0,0,0,0,0,0,0,0,0,0,
            0,0,0,0,0,0,0,0,0,0,0,0,0,
            0,0,0,0,0,0,0,0,0,0,0,0,0,
            0,0,0,0,0,0,0,0,0,0,0,0,0,
            0,0,0,0,0,0,0,0,0,0,0,0,0
        ],
        "flags": []
    },
    {
        "name": "road",
        "usage": "visual",
        "data": [
            0,0,0,0,0,5,5,0,0,0,0,0,0,
            0,0,0,0,0,5,5,0,0,0,0,0,0,
            0,0,0,0,0,5,5,0,0,0,0,0,0,
            0,0,0,0,0,5,5,0,0,0,0,0,0,
            0,0,0,0,0,5,5,0,0,0,0,0,0,
            0,0,0,0,0,5,5,0,0,0,0,0,0,
            0,0,0,0,0,5,5,0,0,0,0,0,0,
            0,0,0,0,0,5,5,0,0,0,0,0,0,
            0,0,0,0,0,5,5,0,0,0,0,0,0,
            0,0,0,0,0,5,5,0,0,0,0,0,0,
            0,0,0,0,0,5,5,0,0,0,0,0,0,
            0,0,0,0,0,5,5,0,0,0,0,0,0,
            0,0,0,0,0,5,5,0,0,0,0,0,0,
            0,0,0,0,0,5,5,0,0,0,0,0,0,
            0,0,0,0,0,5,5,0,0,0,0,0,0,
            0,0,0,0,0,5,5,0,0,0,0,0,0,
            0,0,0,0,0,5,5,0,0,0,0,0,0,
            0,0,0,0,0,5,5,0,0,0,0,0,0,
            0,0,0,0,0,5,5,0,0,0,0,0,0,
            0,0,0,0,0,5,5,0,0,0,0,0,0,
            0,0,0,0,0,5,5,0,0,0,0,0,0,
            0,0,0,0,0,5,5,0,0,0,0,0,0,
            0,0,0,0,0,5,5,0,0,0,0,0,0,
            0,0,0,0,0,5,5,0,0,0,0,0,0,
            0,0,0,0,0,5,5,0,0,0,0,0,0,
            0,0,0,0,0,5,5,0,0,0,0,0,0,
            0,0,0,0,0,5,5,0,0,0,0,0,0,
            0,0,0,0,0,5,5,0,0,0,0,0,0,
            0,0,0,0,0,5,5,0,0,0,0,0,0,
            0,0,0,0,0,5,5,0,0,0,0,0,0,
            0,0,0,0,0,5,5,0,0,0,0,0,0,
            0,0,0,0,0,5,5,0,0,0,0,0,0
        ],
        "flags": []
    },
    {
        "name": "torii",
        "usage": "visual",
        "data": [  
            0,0,0,0,0,0,0,0,0,0,0,0,0,
            0,0,0,0,3,3,3,3,0,0,0,0,0,
            0,0,0,0,3,3,3,3,0,0,0,0,0,
            0,0,0,0,3,3,3,3,0,0,0,0,0,
            0,0,0,0,0,0,0,0,0,0,0,0,0,
            0,0,0,0,3,3,3,3,0,0,0,0,0,
            0,0,0,0,3,3,3,3,0,0,0,0,0,
            0,0,0,0,3,3,3,3,0,0,0,0,0,
            0,0,0,0,0,0,0,0,0,0,0,0,0,
            0,0,0,0,3,3,3,3,0,0,0,0,0,
            0,0,0,0,3,3,3,3,0,0,0,0,0,
            0,0,0,0,3,3,3,3,0,0,0,0,0,
            0,0,0,0,0,0,0,0,0,0,0,0,0,
            0,0,0,0,0,0,0,0,0,0,0,0,0,
            0,0,0,0,0,0,0,0,0,0,0,0,0,
            0,0,0,0,0,0,0,0,0,0,0,0,0,
            0,0,0,0,0,0,0,0,0,0,0,0,0,
            0,0,0,0,0,0,0,0,0,0,0,0,0,
            0,0,0,0,0,0,0,0,0,0,0,0,0,
            0,0,0,0,0,0,0,0,0,0,0,0,0,
            0,0,0,0,0,0,0,0,0,0,0,0,0,
            0,0,0,0,3,3,3,3,0,0,0,0,0,
            0,0,0,0,3,3,3,3,0,0,0,0,0,
            0,0,0,0,3,3,3,3,0,0,0,0,0,
            0,0,0,0,0,0,0,0,0,0,0,0,0,
            0,0,0,0,3,3,3,3,0,0,0,0,0,
            0,0,0,0,3,3,3,3,0,0,0,0,0,
            0,0,0,0,3,3,3,3,0,0,0,0,0,
            0,0,0,0,0,0,0,0,0,0,0,0,0,
            0,0,0,0,3,3,3,3,0,0,0,0,0,
            0,0,0,0,3,3,3,3,0,0,0,0,0,
            0,0,0,0,3,3,3,3,0,0,0,0,0
        ],
        "flags": []
    },
    {
        "name": "collision",
        "usage": "collision",
        "data": [ 
            1,1,1,1,1,1,1,1,1,1,1,1,1,
            1,0,0,0,1,0,0,1,0,0,0,0,1,
            1,0,0,0,1,0,0,1,0,0,0,0,1,
            1,0,0,0,1,0,0,1,0,0,0,0,1,
            1,0,0,0,1,0,0,1,0,0,0,0,1,
            1,0,0,0,1,0,0,1,0,0,0,0,1,
            1,0,0,0,1,0,0,1,0,0,0,0,1,
            1,0,0,0,1,0,0,1,0,0,0,0,1,
            1,0,0,0,1,0,0,1,0,0,0,0,1,
            1,0,0,0,1,0,0,1,0,0,0,0,1,
            1,0,0,0,1,0,0,1,0,0,0,0,1,
            1,0,1,1,1,0,0,1,1,1,0,0,1,
            1,0,1,0,0,0,0,0,0,1,0,0,1,
            1,0,1,0,0,0,0,0,0,1,0,0,1,
            1,0,1,1,1,0,0,1,1,1,0,0,1,
            1,0,1,0,0,0,0,0,0,1,0,0,1,
            1,0,1,0,0,0,0,0,0,1,0,0,1,
            1,0,1,1,1,0,0,1,1,1,0,0,1,
            1,0,0,0,1,0,0,1,0,0,0,0,1,
            1,0,0,0,1,0,0,1,0,0,0,0,1,
            1,0,0,0,1,0,0,1,0,0,0,0,1,
            1,0,0,0,1,0,0,1,0,0,0,0,1,
            1,0,0,0,1,0,0,1,0,0,0,0,1,
            1,0,0,0,1,0,0,1,0,0,0,0,1,
            1,0,0,0,1,0,0,1,0,0,0,0,1,
            1,0,0,0,1,0,0,1,0,0,0,0,1,
            1,0,0,0,1,0,0,1,0,0,0,0,1,
            1,0,0,0,1,0,0,1,0,0,0,0,1,
            1,0,0,0,1,0,0,1,0,0,0,0,1,
            1,0,0,0,1,0,0,1,0,0,0,0,1,
            1,0,0,0,1,0,0,1,0,0,0,0,1,
            1,1,1,1,1,1,1,1,1,1,1,1,1
        ],
        "collisionTypes": {
            "0": { "solid": false },
            "1": { "solid": true }
        }
    },
    { 
        "name": "trigger", 
        "usage": "trigger", 
        "data": [
            0,0,0,0,0,0,0,0,0,0,0,0,0,
            0,0,0,0,0,0,0,0,0,0,0,0,0,
            0,0,0,0,0,0,0,0,0,0,0,0,0,
            0,0,0,0,0,0,0,0,0,0,0,0,0,
            0,0,0,0,0,0,0,0,0,0,0,0,0,
            0,0,0,0,0,0,0,0,0,0,0,0,0,
            0,0,0,0,0,0,0,0,0,0,0,0,0,
            0,0,0,0,0,0,0,0,0,0,0,0,0,
            0,0,0,0,0,0,0,0,0,0,0,0,0,
            0,0,0,0,0,0,0,0,0,0,0,0,0,
            0,0,0,0,0,0,0,0,0,0,0,0,0,
            0,0,0,0,0,0,0,0,0,0,0,0,0,
            0,0,0,2,2,0,0,3,3,0,0,0,0,
            0,0,0,2,2,0,0,3,3,0,0,0,0,
            0,0,0,0,0,0,0,0,0,0,0,0,0,
            0,0,0,4,4,0,0,5,5,0,0,0,0,
            0,0,0,4,4,0,0,5,5,0,0,0,0,
            0,0,0,0,0,0,0,0,0,0,0,0,0,
            0,0,0,0,0,0,0,0,0,0,0,0,0,
            0,0,0,0,0,0,0,0,0,0,0,0,0,
            0,0,0,0,0,0,0,0,0,0,0,0,0,
            0,0,0,0,0,0,0,0,0,0,0,0,0,
            0,0,0,0,0,0,0,0,0,0,0,0,0,
            0,0,0,0,0,0,0,0,0,0,0,0,0,
            0,0,0,0,0,0,0,0,0,0,0,0,0,
            0,0,0,0,0,0,0,0,0,0,0,0,0,
            0,0,0,0,0,0,0,0,0,0,0,0,0,
            0,0,0,0,0,0,0,0,0,0,0,0,0,
            0,0,0,0,0,0,0,0,0,0,0,0,0,
            0,0,0,0,0,0,0,0,0,0,0,0,0,
            0,0,0,0,0,0,0,0,0,0,0,0,0,
            0,0,0,0,0,0,0,0,0,0,0,0,0
         ],
        "triggerTypes": {
            "0": {},
            "2": { 
                "triggerId": "skill.to_pyo" 
            },
            "3": { 
                "triggerId": "skill.to_to" 
            },
            "4": { 
                "triggerId": "skill.to_sha" 
            },
            "5": { 
                "triggerId": "skill.to_kai" 
            }
        }
    }
  ],
  "decorations": [
        {
            "id": "skill.pyo",
            "tileId": "skill.tile.pyo",
            "x": 3,
            "y": 12,
            "size": { "w": 2, "h": 2  },
            "flags": ["skill"]
        },
        {
            "id": "skill.to",
            "tileId": "skill.tile.to",
            "x": 7,
            "y": 12,
            "size": { "w": 2, "h": 2  },
            "flags": ["skill"]
        },
        {
            "id": "skill.sha",
            "tileId": "skill.tile.sha",
            "x": 3,
            "y": 15,
            "size": { "w": 2, "h": 2  },
            "flags": ["skill"]
        },
        {
            "id": "skill.kai",
            "tileId": "skill.tile.kai",
            "x": 7,
            "y": 15,
            "size": { "w": 2, "h": 2  },
            "flags": ["skill"]
        }
    ],
    "triggers": [
        {
            "x": 5,
            "y": 0,
            "width": 2,
            "height": 1,
            "id": "portal.to_boss_room",
            "once": true
        }
    ]
}
