{
    "assetId": "data.map.shrine.tutorial",
    "tilesetId": "data.tileset.map",
    "width": 13,
    "height": 32,
    "layers": [
    {
        "name": "floor",
        "usage": "visual",
        "data": [          
            1,1,1,1,1,1,1,1,1,1,1,1,1,
            1,1,1,1,1,1,1,1,1,1,1,1,1,
            1,1,1,1,1,1,1,1,1,1,1,1,1,
            1,1,1,1,1,1,1,1,1,1,1,1,1,
            1,1,1,1,1,1,1,1,1,1,1,1,1,
            1,1,1,1,1,1,1,1,1,1,1,1,1,
            1,1,1,1,1,1,1,1,1,1,1,1,1,
            1,1,1,1,1,1,1,1,1,1,1,1,1,
            1,1,1,1,1,1,1,1,1,1,1,1,1,
            1,1,1,1,1,1,1,1,1,1,1,1,1,
            1,1,1,1,1,1,1,1,1,1,1,1,1,
            1,1,1,1,1,1,1,1,1,1,1,1,1,
            1,1,1,1,1,1,1,1,1,1,1,1,1,
            1,1,1,1,1,1,1,1,1,1,1,1,1,
            1,1,1,1,1,1,1,1,1,1,1,1,1,
            1,1,1,1,1,1,1,1,1,1,1,1,1,
            1,1,1,1,1,1,1,1,1,1,1,1,1,
            1,1,1,1,1,1,1,1,1,1,1,1,1,
            1,1,1,1,1,1,1,1,1,1,1,1,1,
            1,1,1,1,1,1,1,1,1,1,1,1,1,
            1,1,1,1,1,1,1,1,1,1,1,1,1,
            1,1,1,1,1,1,1,1,1,1,1,1,1,
            1,1,1,1,1,1,1,1,1,1,1,1,1,
            1,1,1,1,1,1,1,1,1,1,1,1,1,
            1,1,1,1,1,1,1,1,1,1,1,1,1,
            1,1,1,1,1,1,1,1,1,1,1,1,1,
            1,1,1,1,1,1,1,1,1,1,1,1,1,
            1,1,1,1,1,1,1,1,1,1,1,1,1,
            1,1,1,1,1,1,1,1,1,1,1,1,1,
            1,1,1,1,1,1,1,1,1,1,1,1,1,
            1,1,1,1,1,1,1,1,1,1,1,1,1,
            1,1,1,1,1,1,1,1,1,1,1,1,1
        ],
        "flags": []
    },
    {
        "name": "road",
        "usage": "visual",
        "data": [
            0,0,0,0,0,5,5,0,0,0,0,0,0,
            0,0,0,0,0,5,5,0,0,0,0,0,0,
            0,0,0,0,0,5,5,0,0,0,0,0,0,
            0,0,0,0,0,5,5,0,0,0,0,0,0,
            0,0,0,0,0,5,5,0,0,0,0,0,0,
            0,0,0,0,0,5,5,0,0,0,0,0,0,
            0,0,0,0,0,5,5,0,0,0,0,0,0,
            0,0,0,0,0,5,5,0,0,0,0,0,0,
            0,0,0,0,0,5,5,0,0,0,0,0,0,
            0,0,0,0,0,5,5,0,0,0,0,0,0,
            0,0,0,0,0,5,5,0,0,0,0,0,0,
            0,0,0,0,0,5,5,0,0,0,0,0,0,
            0,0,0,0,0,5,5,0,0,0,0,0,0,
            0,0,0,0,0,5,5,0,0,0,0,0,0,
            0,0,0,0,0,5,5,0,0,0,0,0,0,
            0,0,0,0,0,5,5,0,0,0,0,0,0,
            0,0,0,0,0,5,5,0,0,0,0,0,0,
            0,0,0,0,0,5,5,0,0,0,0,0,0,
            0,0,0,0,0,5,5,0,0,0,0,0,0,
            0,0,0,0,0,5,5,0,0,0,0,0,0,
            0,0,0,0,0,5,5,0,0,0,0,0,0,
            0,0,0,0,0,5,5,0,0,0,0,0,0,
            0,0,0,0,0,5,5,0,0,0,0,0,0,
            0,0,0,0,0,5,5,0,0,0,0,0,0,
            0,0,0,0,0,5,5,0,0,0,0,0,0,
            0,0,0,0,0,5,5,0,0,0,0,0,0,
            0,0,0,0,0,5,5,0,0,0,0,0,0,
            0,0,0,0,0,5,5,0,0,0,0,0,0,
            0,0,0,0,0,5,5,0,0,0,0,0,0,
            0,0,0,0,0,5,5,0,0,0,0,0,0,
            0,0,0,0,0,5,5,0,0,0,0,0,0,
            0,0,0,0,0,5,5,0,0,0,0,0,0
        ],
        "flags": []
    },
    {
        "name": "collision",
        "usage": "collision",
        "data": [ 
            1,1,1,1,1,1,1,1,1,1,1,1,1,
            1,0,0,0,1,0,0,1,0,0,0,0,1,
            1,0,0,0,1,0,0,1,0,0,0,0,1,
            1,0,0,0,1,0,0,1,0,0,0,0,1,
            1,0,0,0,1,0,0,1,0,0,0,0,1,
            1,0,0,0,1,0,0,1,0,0,0,0,1,
            1,0,0,0,1,0,0,1,0,0,0,0,1,
            1,0,0,0,1,0,0,1,0,0,0,0,1,
            1,0,0,0,1,0,0,1,0,0,0,0,1,
            1,0,0,0,1,0,0,1,0,0,0,0,1,
            1,0,0,0,1,0,0,1,0,0,0,0,1,
            1,0,1,1,1,0,0,1,1,1,0,0,1,
            1,0,1,0,0,0,0,0,0,1,0,0,1,
            1,0,1,0,0,0,0,0,0,1,0,0,1,
            1,0,1,1,1,0,0,1,1,1,0,0,1,
            1,0,1,0,0,0,0,0,0,1,0,0,1,
            1,0,1,0,0,0,0,0,0,1,0,0,1,
            1,0,1,1,1,0,0,1,1,1,0,0,1,
            1,0,0,0,1,0,0,1,0,0,0,0,1,
            1,0,0,0,1,0,0,1,0,0,0,0,1,
            1,0,0,0,1,0,0,1,0,0,0,0,1,
            1,0,0,0,1,0,0,1,0,0,0,0,1,
            1,0,0,0,1,0,0,1,0,0,0,0,1,
            1,0,0,0,1,0,0,1,0,0,0,0,1,
            1,0,0,0,1,0,0,1,0,0,0,0,1,
            1,0,0,0,1,0,0,1,0,0,0,0,1,
            1,0,0,0,1,0,0,1,0,0,0,0,1,
            1,0,0,0,1,0,0,1,0,0,0,0,1,
            1,0,0,0,1,0,0,1,0,0,0,0,1,
            1,0,0,0,1,0,0,1,0,0,0,0,1,
            1,0,0,0,1,0,0,1,0,0,0,0,1,
            1,1,1,1,1,1,1,1,1,1,1,1,1
        ],
        "collisionTypes": {
            "0": { "solid": false },
            "1": { "solid": true }
        }
    },
    { 
        "name": "trigger", 
        "usage": "trigger", 
        "data": [
            0,0,0,0,0,0,0,0,0,0,0,0,0,
            0,0,0,0,0,0,0,0,0,0,0,0,0,
            0,0,0,0,0,0,0,0,0,0,0,0,0,
            0,0,0,0,0,0,0,0,0,0,0,0,0,
            0,0,0,0,0,0,0,0,0,0,0,0,0,
            0,0,0,0,0,0,0,0,0,0,0,0,0,
            0,0,0,0,0,0,0,0,0,0,0,0,0,
            0,0,0,0,0,0,0,0,0,0,0,0,0,
            0,0,0,0,0,0,0,0,0,0,0,0,0,
            0,0,0,0,0,0,0,0,0,0,0,0,0,
            0,0,0,0,0,0,0,0,0,0,0,0,0,
            0,0,0,0,0,0,0,0,0,0,0,0,0,
            0,0,0,2,2,0,0,3,3,0,0,0,0,
            0,0,0,2,2,0,0,3,3,0,0,0,0,
            0,0,0,0,0,0,0,0,0,0,0,0,0,
            0,0,0,4,4,0,0,5,5,0,0,0,0,
            0,0,0,4,4,0,0,5,5,0,0,0,0,
            0,0,0,0,0,0,0,0,0,0,0,0,0,
            0,0,0,0,0,0,0,0,0,0,0,0,0,
            0,0,0,0,0,0,0,0,0,0,0,0,0,
            0,0,0,0,0,0,0,0,0,0,0,0,0,
            0,0,0,0,0,0,0,0,0,0,0,0,0,
            0,0,0,0,0,0,0,0,0,0,0,0,0,
            0,0,0,0,0,0,0,0,0,0,0,0,0,
            0,0,0,0,0,0,0,0,0,0,0,0,0,
            0,0,0,0,0,0,0,0,0,0,0,0,0,
            0,0,0,0,0,0,0,0,0,0,0,0,0,
            0,0,0,0,0,0,0,0,0,0,0,0,0,
            0,0,0,0,0,0,0,0,0,0,0,0,0,
            0,0,0,0,0,0,0,0,0,0,0,0,0,
            0,0,0,0,0,0,0,0,0,0,0,0,0,
            0,0,0,0,0,0,0,0,0,0,0,0,0
         ],
        "triggerTypes": {
            "2": { 
                "triggerId": "skill.to_pyo" 
            },
            "3": { 
                "triggerId": "skill.to_to" 
            },
            "4": { 
                "triggerId": "skill.to_sha" 
            },
            "5": { 
                "triggerId": "skill.to_kai" 
            }
        }
    }
  ],
  "decorations": [
        {
            "id": "portal.region.0",
            "tileId": "portal",
            "x": 4,
            "y": 1,
            "size": { "w": 4, "h": 3  },
            "flags": []
        },
        {
            "id": "portal.region.1",
            "tileId": "portal",
            "x": 4,
            "y": 5,
            "size": { "w": 4, "h": 3  },
            "flags": []
        },
       {
            "id": "portal.region.2",
            "tileId": "portal",
            "x": 4,
            "y": 9,
            "size": { "w": 4, "h": 3  },
            "flags": []
        },
        {
            "id": "portal.region.3",
            "tileId": "portal",
            "x": 4,
            "y": 21,
            "size": { "w": 4, "h": 3  },
            "flags": []
        },
        {
            "id": "portal.region.4",
            "tileId": "portal",
            "x": 4,
            "y": 25,
            "size": { "w": 4, "h": 3  },
            "flags": []
        },
        {
            "id": "portal.region.5",
            "tileId": "portal",
            "x": 4,
            "y": 29,
            "size": { "w": 4, "h": 3  },
            "flags": []
        },


        {
            "id": "skill.pyo",
            "tileId": "skill.tile.pyo",
            "x": 3,
            "y": 12,
            "size": { "w": 2, "h": 2  },
            "flags": ["skill"]
        },
        {
            "id": "skill.to",
            "tileId": "skill.tile.to",
            "x": 7,
            "y": 12,
            "size": { "w": 2, "h": 2  },
            "flags": ["skill"]
        },
        {
            "id": "skill.sha",
            "tileId": "skill.tile.sha",
            "x": 3,
            "y": 15,
            "size": { "w": 2, "h": 2  },
            "flags": ["skill"]
        },
        {
            "id": "skill.kai",
            "tileId": "skill.tile.kai",
            "x": 7,
            "y": 15,
            "size": { "w": 2, "h": 2  },
            "flags": ["skill"]
        }
    ],
    "triggers": [
        {
            "x": 5,
            "y": 0,
            "size": { "w": 2, "h": 2  },
            "triggerId": "portal.to_boss_room",
            "once": true
        },
        {
            "triggerId": "skill.to_pyo",

            "x": 3,
            "y": 13,
            "size": { "w": 2, "h": 2 },
            "once": false
            
        },
        {
            "triggerId": "skill.to_to",

            "x": 3,
            "y": 9,
            "size": { "w": 2, "h": 2 },
            "once": false
            
        },
        {
            "triggerId": "skill.to_sha",

            "x": 6,
            "y": 5,
            "size": { "w": 2, "h": 2 },
            "once": false
            
        },
        {
            "triggerId": "skill.to_kai",
            
            "x": 11,
            "y": 3,
            "size": { "w": 2, "h": 2 },
            "once": false
            
        }
    ]
}
